# Country codes used by IMDB - shortened names for certificate display.
au=Australia
at=Austria
be=Belgium
br=Brazil
bg=Bulgaria
ca=Canada
cl=Chile
cn=China
cz=Czech Republic
dk=Denmark
eg=Egypt
ee=Estonia
fi=Finland
fr=France
de=Germany
gr=Greece
hk=Hong KONG
hu=Hungary
is=Iceland
in=India
id=Indonesia
ie=Ireland
it=Italy
jp=Japan
kp=Korea
kr=Korea
lv=Latvia
my=Malaysia
mv=Maldives
mt=Malta
mx=Mexico
nl=Netherlands
nz=New Zealand
ng=Nigeria
no=Norway
pe=Peru
ph=Philippines
pl=Poland
pt=Portugal
ro=Romania
sg=Singapore
za=South Africa
es=Spain
se=Sweden
ch=Switzerland
tw=Taiwan
th=Thailand
tc=Turks And Caicos Islands
ae=UAE
gb=UK
us=USA
um=USA
